111111111
110C000P1
1E0100001
111111111
111111111
111111111
111111111
111111111
111111111