11111111
1P00C0E1
100000C1
11111111